Commit Hash, High Severity, Medium Severity, Low Severity, High Confidence, Medium Confidence, Low Confidence, Total Issues, CWEs
c21c54ceec7f0514413c280bf459f866f881a70f, 17, 68, 809, 878, 6, 10, 894, "20;22;259;295;327;330;400;502;605;703;78;89;"
281cf5005525d101b7c4df93e42960b5217ce89b, 17, 68, 809, 878, 6, 10, 894, "20;22;259;295;327;330;400;502;605;703;78;89;"
18353f599183cc3da59c689dc85993bb110ab545, 17, 67, 805, 874, 6, 9, 889, "20;22;259;295;327;330;400;502;605;703;78;89;"
7c2ccfbc76f141436092b6f2610c4e4258eb58e9, 17, 67, 805, 874, 6, 9, 889, "20;22;259;295;327;330;400;502;605;703;78;89;"
08062def37630d1f5eef59bce054462b0c52a0ab, 17, 67, 805, 874, 6, 9, 889, "20;22;259;295;327;330;400;502;605;703;78;89;"
c475be9d6661c6ebbbb2dedf711133341f7340c4, 17, 67, 805, 874, 6, 9, 889, "20;22;259;295;327;330;400;502;605;703;78;89;"
745a61db28b3c1990016c5c9f9ff3aabb5de119f, 17, 67, 805, 874, 6, 9, 889, "20;22;259;295;327;330;400;502;605;703;78;89;"
70bd296687c643cd211dffa3119024074393fb5c, 17, 67, 804, 873, 6, 9, 888, "20;22;259;295;327;330;400;502;605;703;78;89;"
507544a4ac3ab90ed4c96e4e5c1df6113041aee5, 17, 67, 804, 873, 6, 9, 888, "20;22;259;295;327;330;400;502;605;703;78;89;"
89dc7cf9ee53208b55ff199f6b070bd3f1fcc925, 17, 67, 804, 873, 6, 9, 888, "20;22;259;295;327;330;400;502;605;703;78;89;"
2881a4b83fac225e0254319cbab1725510479328, 17, 67, 804, 873, 6, 9, 888, "20;22;259;295;327;330;400;502;605;703;78;89;"
25b3a7a879026aa1b3c7d5f8942b2d5073ab438b, 17, 67, 804, 873, 6, 9, 888, "20;22;259;295;327;330;400;502;605;703;78;89;"
a093c6d9de337b68de21978f2cc763a8506c2551, 17, 67, 804, 873, 6, 9, 888, "20;22;259;295;327;330;400;502;605;703;78;89;"
255dc9ffc1a887858a64ffeb14f50076529ae9c4, 17, 67, 796, 865, 6, 9, 880, "20;22;259;295;327;330;400;502;605;703;78;89;"
87bf0a1efb15ae6f6e254f82e20ff303c4ed69f1, 17, 67, 796, 865, 6, 9, 880, "20;22;259;295;327;330;400;502;605;703;78;89;"
12a413ccf07a0a7a52c977e59b827d61445f19c7, 17, 67, 796, 865, 6, 9, 880, "20;22;259;295;327;330;400;502;605;703;78;89;"
5ba810c897cf2241e4586672165dde6f092f5487, 17, 67, 796, 865, 6, 9, 880, "20;22;259;295;327;330;400;502;605;703;78;89;"
f4473ddcd7bf478471453ed10758fd1e9ddf2427, 17, 67, 796, 865, 6, 9, 880, "20;22;259;295;327;330;400;502;605;703;78;89;"
5606b277799a42330b7eeef5a10468e23cb185ff, 17, 67, 796, 865, 6, 9, 880, "20;22;259;295;327;330;400;502;605;703;78;89;"
ada8039af3571e6b41d4f8f543ad420670e020a5, 17, 67, 796, 865, 6, 9, 880, "20;22;259;295;327;330;400;502;605;703;78;89;"
43c3b3e1553a88d98b43bc8f8d77fc5bd89031f2, 17, 67, 796, 865, 6, 9, 880, "20;22;259;295;327;330;400;502;605;703;78;89;"
7fdfd7ffbb863a1406ad954aa5cbbe5221322b5b, 17, 67, 796, 865, 6, 9, 880, "20;22;259;295;327;330;400;502;605;703;78;89;"
e61318f5c750e2d91a93ce3d79396a6b43e0a413, 17, 69, 798, 869, 6, 9, 884, "20;22;259;295;327;330;400;502;605;703;78;89;"
f1e354d01fc8aa211d78798c9d78035a7f2474cc, 17, 69, 798, 869, 6, 9, 884, "20;22;259;295;327;330;400;502;605;703;78;89;"
96f996207da7e3147506e4be4fe374cb39243e28, 17, 69, 798, 869, 6, 9, 884, "20;22;259;295;327;330;400;502;605;703;78;89;"
1b17d24853c1142bb410f8d03e1271e01e7a09cc, 17, 69, 798, 869, 6, 9, 884, "20;22;259;295;327;330;400;502;605;703;78;89;"
9946452e3e333c2730e09069d5f41456eccfab18, 17, 69, 798, 869, 6, 9, 884, "20;22;259;295;327;330;400;502;605;703;78;89;"
cb0d74ce2cb1c53957a5914956e1e0e221ecfd74, 17, 69, 798, 869, 6, 9, 884, "20;22;259;295;327;330;400;502;605;703;78;89;"
30368d035c34e4548fb920c77ac4005d1dde8759, 17, 69, 798, 869, 6, 9, 884, "20;22;259;295;327;330;400;502;605;703;78;89;"
3f70ca93484c26921cc5ded1f440f1556f4c589e, 17, 69, 798, 869, 6, 9, 884, "20;22;259;295;327;330;400;502;605;703;78;89;"
883bb866033868beec7ef146e81a5b43b5b39dce, 17, 69, 798, 869, 6, 9, 884, "20;22;259;295;327;330;400;502;605;703;78;89;"
87d68624356186d94b68d29cd19462f056fd4b6e, 17, 69, 798, 869, 6, 9, 884, "20;22;259;295;327;330;400;502;605;703;78;89;"
35546daf544811ab7791e33f9b85007ed398d3a3, 17, 69, 798, 869, 6, 9, 884, "20;22;259;295;327;330;400;502;605;703;78;89;"
0260d69f8592ed8c8b9cbce11b1011c92287f07a, 17, 69, 798, 869, 6, 9, 884, "20;22;259;295;327;330;400;502;605;703;78;89;"
4a2e69a75509c3f29a7578600248ecab623097ac, 17, 69, 798, 869, 6, 9, 884, "20;22;259;295;327;330;400;502;605;703;78;89;"
4097d8c4b42ff44bd12fc7e3449babe8e202d104, 17, 69, 798, 869, 6, 9, 884, "20;22;259;295;327;330;400;502;605;703;78;89;"
88e7cfa40094efec80173edd325da709f7a7a653, 17, 69, 798, 869, 6, 9, 884, "20;22;259;295;327;330;400;502;605;703;78;89;"
4fd79979548c007af773ee899e24d9991ff5eddc, 17, 75, 859, 930, 6, 15, 951, "20;22;259;295;327;330;400;502;605;703;78;89;"
ba0021a14f7a0ec9c125bf85b45098b2e6cda248, 17, 75, 859, 930, 6, 15, 951, "20;22;259;295;327;330;400;502;605;703;78;89;"
b9cd149a9f18bba7f1e3341c074b00caa106c142, 17, 75, 854, 925, 6, 15, 946, "20;22;259;295;327;330;400;502;605;703;78;89;"
3d4230b54e9f382281fd74bbc479ddb673b3dc6c, 17, 75, 854, 925, 6, 15, 946, "20;22;259;295;327;330;400;502;605;703;78;89;"
95582de7adc3cdd87c87013348476df761988cbd, 17, 75, 854, 925, 6, 15, 946, "20;22;259;295;327;330;400;502;605;703;78;89;"
e31182017aac5f8785611ed69aeeb8798fe92a8a, 17, 75, 854, 925, 6, 15, 946, "20;22;259;295;327;330;400;502;605;703;78;89;"
877f1dfe78d9b05101de493a02483e1e09363ba1, 12, 73, 852, 917, 6, 14, 937, "20;22;259;295;327;330;400;502;605;703;78;89;"
e9ef8eb8d0212522ca2d043b54b947064ec0d178, 12, 67, 788, 853, 6, 8, 867, "20;22;259;295;327;330;400;502;605;703;78;89;"
e450817284bb4a1ecca45214e075f53e50892694, 12, 67, 788, 853, 6, 8, 867, "20;22;259;295;327;330;400;502;605;703;78;89;"
4f9b34fbd218e1cc7e7632da905e99634523b21f, 12, 67, 788, 853, 6, 8, 867, "20;22;259;295;327;330;400;502;605;703;78;89;"
ccf93b4c514e5a394e13cc2a04a324cb1bb9bedc, 12, 67, 788, 853, 6, 8, 867, "20;22;259;295;327;330;400;502;605;703;78;89;"
542b3f9fc44fabd3acb23669e2dce1667c19d9c3, 12, 67, 788, 853, 6, 8, 867, "20;22;259;295;327;330;400;502;605;703;78;89;"
1cbd9967b94781817c96b8c2deb693a1e0c5dd99, 12, 67, 788, 853, 6, 8, 867, "20;22;259;295;327;330;400;502;605;703;78;89;"
f947ba5f0f9edc81a96a78a633524d7514eb7080, 12, 67, 788, 853, 6, 8, 867, "20;22;259;295;327;330;400;502;605;703;78;89;"
e02fc9cd966b4f6719322ff32d94c17c829b889e, 12, 67, 788, 853, 6, 8, 867, "20;22;259;295;327;330;400;502;605;703;78;89;"
eb56761a0d83247c56637504661dbffa1488e2fa, 12, 67, 788, 853, 6, 8, 867, "20;22;259;295;327;330;400;502;605;703;78;89;"
76ea292daf19ba96f8b2f4b4c61a3f7d98d2b58d, 12, 67, 788, 853, 6, 8, 867, "20;22;259;295;327;330;400;502;605;703;78;89;"
9714e91e4f72eb4bcccb5a59169d14331dd508f4, 12, 67, 788, 853, 6, 8, 867, "20;22;259;295;327;330;400;502;605;703;78;89;"
60248ccf1a167f63e95db55bd8ffaf4e47654d0c, 12, 67, 788, 853, 6, 8, 867, "20;22;259;295;327;330;400;502;605;703;78;89;"
556b11509f8a9b9638260395488c91e187233cbb, 12, 67, 788, 853, 6, 8, 867, "20;22;259;295;327;330;400;502;605;703;78;89;"
4afa639e1dcf91c90b1b5a72e1a6bc6723d99aa7, 12, 67, 788, 853, 6, 8, 867, "20;22;259;295;327;330;400;502;605;703;78;89;"
96eedcdd20fb4f1a145c9740c6af64c6e5839f9d, 12, 67, 788, 853, 6, 8, 867, "20;22;259;295;327;330;400;502;605;703;78;89;"
8bfda73a3f43e90a2d3dcfa4c73c853b15c88dbd, 12, 67, 788, 853, 6, 8, 867, "20;22;259;295;327;330;400;502;605;703;78;89;"
fe2906f0712a4c27b68c35c488bde0b190627e59, 12, 67, 788, 853, 6, 8, 867, "20;22;259;295;327;330;400;502;605;703;78;89;"
2f4fa28df7512c5e3c3da5e0bc7a8edaacef75b2, 12, 67, 788, 853, 6, 8, 867, "20;22;259;295;327;330;400;502;605;703;78;89;"
51fa2146a62c071bfd60efaaea881fd615ec85ed, 12, 67, 788, 853, 6, 8, 867, "20;22;259;295;327;330;400;502;605;703;78;89;"
8defcf844277c2c6f81968feadbc0997800504f9, 12, 67, 788, 853, 6, 8, 867, "20;22;259;295;327;330;400;502;605;703;78;89;"
1c02a269098e019d707dcc91952ef94ea89b88bf, 12, 67, 782, 847, 6, 8, 861, "20;22;259;295;327;330;400;502;605;703;78;89;"
c8a95258c4bee8ec17e0df999244a828f8274e81, 12, 67, 781, 846, 6, 8, 860, "20;22;259;295;327;330;400;502;605;703;78;89;"
be663c70e78aa20a8748aeb69bd281d8bbf5c03e, 12, 67, 781, 846, 6, 8, 860, "20;22;259;295;327;330;400;502;605;703;78;89;"
4f525ad963561c51ef9c15decd73b44c25b94e13, 12, 67, 781, 846, 6, 8, 860, "20;22;259;295;327;330;400;502;605;703;78;89;"
bce201171a4a930ea367bdbadc7b7082bdacf664, 12, 66, 779, 844, 5, 8, 857, "20;22;259;295;327;330;400;502;605;703;78;89;"
40f8a4a981967e67e3e3bac5f1ef7958a854ef45, 12, 66, 779, 844, 5, 8, 857, "20;22;259;295;327;330;400;502;605;703;78;89;"
4634ae32e8aab41311da8a9da3fa492a9992610b, 12, 66, 779, 844, 5, 8, 857, "20;22;259;295;327;330;400;502;605;703;78;89;"
1ae1468612b6adbc5ef59b633008b563902580ca, 12, 66, 779, 844, 5, 8, 857, "20;22;259;295;327;330;400;502;605;703;78;89;"
96ef0ffbc30f824603afb99a7d12536aa148f1fe, 12, 66, 779, 844, 5, 8, 857, "20;22;259;295;327;330;400;502;605;703;78;89;"
be506a38d58829b58a2dc0ed5e4997cddc117692, 12, 66, 779, 844, 5, 8, 857, "20;22;259;295;327;330;400;502;605;703;78;89;"
bf0d03d45795093f4ba18627df705d6aa68bbb55, 12, 66, 780, 845, 5, 8, 858, "20;22;259;295;327;330;400;502;605;703;78;89;"
7f1d8b730e3185669d03dbfaaa59b0c82a5f0bb0, 12, 66, 780, 845, 5, 8, 858, "20;22;259;295;327;330;400;502;605;703;78;89;"
cc008927f10867243e032bd6004c2fece724f384, 12, 66, 780, 845, 5, 8, 858, "20;22;259;295;327;330;400;502;605;703;78;89;"
2ec05611442e90fa5a6371df138fc4a8ba78a120, 12, 66, 780, 845, 5, 8, 858, "20;22;259;295;327;330;400;502;605;703;78;89;"
0538cb6e6a64e95e93c82d7c65df2b277eabeeca, 12, 66, 780, 845, 5, 8, 858, "20;22;259;295;327;330;400;502;605;703;78;89;"
42e2e7cfd507f9cb4842d3e361844849d745cb4e, 12, 66, 780, 845, 5, 8, 858, "20;22;259;295;327;330;400;502;605;703;78;89;"
408129bbdbfa73443a2f8ff75f887d9d5f2aba68, 12, 66, 780, 845, 5, 8, 858, "20;22;259;295;327;330;400;502;605;703;78;89;"
744f7bbadeaa06eec628148e81e977f67942c1c6, 12, 66, 780, 845, 5, 8, 858, "20;22;259;295;327;330;400;502;605;703;78;89;"
c007d6783e75086cba18b6e08c0034a76cecba96, 12, 66, 780, 845, 5, 8, 858, "20;22;259;295;327;330;400;502;605;703;78;89;"
cbd75f28ae7f0c944352e4fa7bf0b129e38f94cf, 12, 66, 780, 845, 5, 8, 858, "20;22;259;295;327;330;400;502;605;703;78;89;"
723dc21efad3859af89de178131c2da370e18de3, 12, 66, 780, 845, 5, 8, 858, "20;22;259;295;327;330;400;502;605;703;78;89;"
b5072cb6f4c231c121d853250eb28dc6b49bd2b9, 12, 66, 780, 845, 5, 8, 858, "20;22;259;295;327;330;400;502;605;703;78;89;"
971f4ea4f63d4531a7ca5ac48681011f84069ed1, 12, 66, 780, 845, 5, 8, 858, "20;22;259;295;327;330;400;502;605;703;78;89;"
4e315425d17c481c63d0adc0b0dc0e1960ab80c0, 12, 66, 780, 845, 5, 8, 858, "20;22;259;295;327;330;400;502;605;703;78;89;"
f444c288917f5215abee2738b0166bcdbdd6b2f1, 12, 66, 780, 845, 5, 8, 858, "20;22;259;295;327;330;400;502;605;703;78;89;"
a9d12a8daecb4d70b0ad50ad68534187b9aae796, 12, 66, 780, 845, 5, 8, 858, "20;22;259;295;327;330;400;502;605;703;78;89;"
faa42549abb443783f04d6cd2b9f5e7279bf25b1, 12, 66, 780, 845, 5, 8, 858, "20;22;259;295;327;330;400;502;605;703;78;89;"
89b79591bd429264d0f03bb90cbd348e09eac60c, 12, 66, 780, 845, 5, 8, 858, "20;22;259;295;327;330;400;502;605;703;78;89;"
14063a255d8ff294c67e952723c256aecd0b210f, 12, 66, 780, 845, 5, 8, 858, "20;22;259;295;327;330;400;502;605;703;78;89;"
1350ef41ede17dff8b8dca5224f8a88d550a93ca, 12, 66, 788, 853, 5, 8, 866, "20;22;259;295;327;330;400;502;605;703;78;89;"
1899570f83c72e7733a7234608d69de7aadcacd8, 12, 66, 792, 857, 5, 8, 870, "20;22;259;295;327;330;400;502;605;703;78;89;"
c2a3135aac7989ea7f9ccfe3544972cb3a673c92, 12, 66, 788, 853, 5, 8, 866, "20;22;259;295;327;330;400;502;605;703;78;89;"
54657226d508bc6ecac8d9e0c879f4f30ec5092b, 12, 66, 791, 856, 5, 8, 869, "20;22;259;295;327;330;400;502;605;703;78;89;"
dc0aaa14d160fb642de32cbf70e9c5e4c8d8a0c7, 12, 66, 791, 856, 5, 8, 869, "20;22;259;295;327;330;400;502;605;703;78;89;"
54a35365eb6fb233c1c79d0edf92080618e56182, 12, 66, 791, 856, 5, 8, 869, "20;22;259;295;327;330;400;502;605;703;78;89;"
41f9d3d31f8e0c57f3a77c8f777f15f453ab77b6, 12, 66, 791, 856, 5, 8, 869, "20;22;259;295;327;330;400;502;605;703;78;89;"
